
NO ./path_to_the_noth_texture   





SO ./path_to_the_south_texture
WE ./path_to_the_west_texture
EA ./path_to_the_east_texture

F 220,100,0
                             
     C 225,30,0

dfgdf
gfhfgh        
n


sdfdsfdsfdsf


111111111111111111111111111111111
100000001000000000110000000000001
100000000011000001110000000000001
100000001100100000000000000000001
111101111011000001110000000000001
100000000011000001110111111111111
111101111111110111000000100000001
111101111111110111010100100000001
110000001101010111000000000000001
100000000000000000000000100000001
100000000000000011010100100000001
11000001110101001111011110N000011
110101111111010111011110100000001
111111111111111111111111111111111



