

                                                NO                   texture
SO ./texture1
WE ./texture2
EA ./texture3

C 100,30,40
F 200,100,220

111111
N01101
101001
110011
111111


















