
C 225,30,0

                                                NO                   test
SO ./path_to_the_south_texture
WE ./path_to_the_west_texture
EA ./path_to_the_east_texture

                                                        F                                                                220,              100,   0
 F                            
F

C
dfgdf
gfhfgh        
n


sdfdsfdsfdsf

1111111111111111111111
1000000000000000000001
10000000E0000000000001
1000000000000000000001
1000000000000000000001
1000000000000000000001
1000000000100000000001
1000000000000000000001
1000000011100000000001
1000000000000000000001
1000000010001000000001
1000000000000000000001
1000000000000000000001
1000000000000000000001
1000000000000000000001
1000000000000000000001
1000000010000000000001
1000000000000000000001
1111111111111111111111



