WE texture.xpm
SO texture.xpm
EA texture.xpm
NO texture.xpm
C 1,0,111
F 50,100,255

        1111111111111111111111111
        10000000001100000000000001
        1011000001110000000000001
        10010000000000000N0000001
111111111011000001110000000000001
10000000001100000111011110001111
11110111111111011100000010001
11110111111111011101010010001
11000000110101011100000010001
10000000000000001100000010001
10000000000000001101010010001
1100000111010101111101111000111
11110111 1110101 101111010001
11111111 1111111 111111111111



