WE /Users/mmeziani/Desktop/cub3D-main/texture2
SO texture1
EA texture2
NO tex ture
NO

C 1,0,1
F 50,100,255

1111111111
111111111
1110000001
11111000111
11100011111
1111N111111
11111111111
1111111